0 5 2 0 5 2 0 0 2 0 0 0
0 0 2 0 0 2 0 0 2 0 5 0
0 0 2 0 0 2 0 0 2 0 0 0
0 0 2 0 0 2 0 0 2 0 0 0
0 0 2 0 0 2 0 0 2 0 0 0
0 0 2 0 0 2 0 0 2 0 0 0
0 0 2 0 0 2 0 0 2 0 0 0
0 0 2 0 0 2 0 0 2 0 0 0
0 0 2 0 0 2 0 5 2 0 0 3
0 0 2 0 0 2 0 0 2 0 0 0
0 0 2 0 0 2 0 0 2 0 0 0
0 0 2 0 0 2 0 0 2 0 0 0
0 0 2 0 0 2 0 0 2 0 0 0
5 0 2 5 0 2 4 0 2 0 0 5